9 23
#######################
E.....#.........#.#.#.#
#.###.#.#.###.#.......#
#.#...#.#.#.#..#..###.#
#.#####.#...#.#.#.#.#.#
#....#...####.#.#...#.#
##.#.#.#.#.#...######.#
#..#...#...#.#......#.S
#######################